贊	賛
籃	籃
邀	邀
衡	衡
膨	膨
雕	雕
磨	磨
凝	凝
辨	辨
辯	辯
糖	糖
糕	糕
燃	燃
澡	澡
激	激
懶	懶
壁	壁
避	避
繳	繳
戴	戴
擦	擦
鞠	鞠
藏	蔵
霜	霜
霞	霞
瞧	瞧
蹈	蹈
螺	螺
穗	穂
繁	繁
辮	辮
贏	贏
糟	糟
糠	糠
燥	燥
臂	臂
翼	翼
驟	驟
鞭	鞭
覆	覆
蹦	蹦
鐮	鐮
翻	翻
鷹	鷹
警	警
攀	攀
蹲	蹲
顫	顫
瓣	瓣
爆	爆
疆	疆
壤	壌
耀	耀
躁	躁
嚼	嚼
嚷	嚷
籍	籍
魔	魔
灌	潅
蠢	蠢
霸	霸
露	露
囊	嚢
